_______________________________________________________________________________________________________________________
_______________________________________________________________________________________________________________________
_______________________________________________________________________________________________________________________
__11111111111111111111111111111111111111111111111111111111111111111111111111111111111111111111111111111111111111111111_
_11___________________________________________________________________________________________________________________1
_1____________________________________________________________________________________________________________________1
_1_________________________________________________________________________________________________11111111111111111111
_1____________________________________________________________________________________________________________________1
_1____________________________________________________________________________11111____11111__________________________1
_1____________________________________________________________________________________________________________________1
_1____________________________________________________________________________________________________________________1
_1____________________________________________________________________________________________________________________1
_1____________________________________________________________________________________________________________________1
_1__111111___________________________________________________________________________________________________111___1111
_1__111111_______1____________________________________________________________________________________________________1
_1__111111______1111__________________________________________________________________________________________________1
_1__111111______1111__________________________________________________________________________________________________1
_1__111111______1111__________________________________________________________________________________________________1
_1111111111111111111111111111111111111111111111111111111111111________________________________________________________1
_____________________________________________________________1________________________________________________________1
_____________________________________________________________1________________________________________________________1
_____________________________________________________________1________________________________________________________1
_____________________________________________________________1________________________________________________________1
_____________________________________________________________1________________________________________________________1
_____________________________________________________________1________________________________________________________1
_____________________________________________________________1________________________________________________________1
_____________________________________________________________1________________________________________________________1
_____________________________________________________________1________________________________________________________1
_____________________________________________________________1________________________________________________________1
_____________________________________________________________1________________________________________________________1
_____________________________________________________________1________________________________________________________1
_____________________________________________________________1________________________________________________________1
_____________________________________________________________1________________________________________________________1
_____________________________________________________________1________________________________________________________1
_____________________________________________________________1________________________________________________________1
_____________________________________________________________1________________________________________________________1
_____________________________________________________________1___________________________________1111111______________1
_____________________________________________________________1___________________________________1111111______________1
_____________________________________________________________1___________________________________1111111111___________1
_1111111111111111111111111111111111111111111111111111111111111___________________________________1111111111___________1
_1_______________________________________________________________________________________________1111111______________1
_1_______________________________________________________________________________________________1111111______________1
_1_______________________________________________________________________________________________1111111______________1
_1____________________________________________________________________________________________________________________1
_1____________________________________________________________________________________________________________________1
_1____________________________________________________________________________________________________________________1
_1111111111111111111111111111111111111111111111111111111111111____________________________________________________11111
_____________________________________________________________1________________________________________________________1
_____________________________________________________________1________________________________________________________1
_____________________________________________________________1________________________________________________________1
_____________________________________________________________1________________________________________________________1
_____________________________________________________________1________________________________________________________1
_____________________________________________________________1________________________________________________________1
_____________________________________________________________1___________________________________________1111111111___1
_____________________________________________________________1___________________________________________1111111111___1
_____________________________________________________________1___________________________________________1111111111___1
_____________________________________________________________1___________________________________________1111111111___1
_____________________________________________________________1___________________________________________1111111111___1
_____________________________________________________________1___________________________________________1111111111___1
_____________________________________________________________1___________________________________________1111111111___1
_____________________________________________________________1________________________________________________________1
_____________________________________________________________1________________________________________________________1
_____________________________________________________________1________________________________________________________1
_____________________________________________________________1________________________________________________________1
_____________________________________________________________1________________________________________________________1
______________________________________________________________11111111111111111111111111111111111111111111111111111111_