_______________________________________________________________________________________________________________________
_______________________________________________________________________________________________________________________
_______________________________________________________________________________________________________________________
__11111111111111111111111111111111111111111111111111111111111111111111111111111111111111111111_________________________
_1_______111111______________1________________________________________________________________1________________________
_1____________________________________________________________________________________________1________________________
_1____________________________________________________________________________________________1________________________
_1____________________________________________________________________________________________1________________________
_1____________________________________________________________________________________________1________________________
_1____________________________________________________________________________________________1________________________
_1____________________________________________________________________________________________1________________________
_1____________________________________________________________________________________________1________________________
_1_______________________________c_____________________________________________________________1________________________
_1____________________________________________________________________________________________1________________________
_1____________________________________________________________________________________________1________________________
_1____________________________________________________________________________________________1________________________
_1_______11111______11111_____________________________________________________________________1________________________
_1____________________________________________________________________________________________1________________________
_1____________________________________________________________________________________________1________________________
_1____________________________________________________________________________________________1________________________
_1____________________________________________________________________________________________1________________________
_1____________________________________________________________________________________________1________________________
_1____________________________________________________________________________________________1________________________
_1____________________________________________________________________________________________1________________________
_1____________________________________________________________________________________________1________________________
_111111_______________________________________________________________________________________1________________________
_111111____________1111111_______1111111______________________________________________________1________________________
_111111_______________________________________________________________________________________1________________________
_1____________________________________________________________________________________________1________________________
_1____________________________________________________________________________________________1________________________
_1____________________________________________________________________________________________1________________________
_1____________________________________________________________________________________________1________________________
_1____________________________________________________________________________________________1________________________
_111111_______________________________________________________________________________________1________________________
_11111_____________1111111_______1111111______________________________________________________1________________________
_11111________________________________________________________________________________________1________________________
_11111________________________________________________________________________________________1________________________
_11111________________________________________________________________________________________1________________________
_11111________________________________________________________________________________________1________________________
_11111________________________________________________________________________________________1________________________
_11111________________________________________________________________________________________1________________________
_11111________________________________________________________________________________________1________________________
_11111_____________1111111_______1111111______________________________________________________1________________________
_1____________________________________________________________________________________________1________________________
_1____________________________________________________________________________________________1________________________
_1____________________________________________________________________________________________1________________________
_1____________________________________________________________________________________________1________________________
_1____________________________________________________________________________________________1________________________
_1____________________________________________________________________________________________1________________________
_1____________________________________________________________________________________________1________________________
_1____________________________________________________________________________________________1________________________
_1_____________________________11_____________________________________________________________1________________________
_1_____________________11111__________________________________________________________________1________________________
_1___1111111__________________________________________________________________________________1________________________
_1____________________________________________________________________________________________1________________________
_1____________________________________________________________________________________________1________________________
_1____________________________________________________________________________________________1________________________
_1____________________________________________________________________________________________1________________________
_1____________________1111111_________________________________________________________________1________________________
_1____1111____11______________________________________________________________________________1________________________
_1____________________________________________________________________________________________1________________________
_1____________________________________________________________________________________________1________________________
_1____________________________________________________________________________________________1________________________
_1____________________________________________________________________________________________1________________________
_1____________________________________________________________________________________________1________________________
__11111111111111111111111111111111111111111111111111111111111111111111111111111111111111111111_________________________