_______________________________________________________________________________________________________________________
_______________________________________________________________________________________________________________________
_______________________________________________________________________________________________________________________
_________________11111111111111111111111111111111111111111111111111111111111111111111111111111111111111111111111111111_
________________1______________________________________1______________________11______________________11______________1
________________1_____________________________________________________________________________________________________1
________________1_____________________________________________________________________________________________________1
________________1_____________________________________________________________________________________________________1
________________1_____________________________________________________________________________________________________1
________________1_____________________________________________________________________________________________________1
________________1___________________________________________________________________________________________1111111___1
________________1____________________________________________________________________________________________11111____1
________________1____________________________________________________________________________________________11111____1
________________1____________________________________________________________________________________________11111____1
________________1_____________________________________________________________11_____11_____11____11_________11111____1
________________1_____________________________________________________________11_____11_____11____11_________11111____1
________________1_________________________________________________________________________________11__________________1
________________1111111111________________________________________________________________________11__________________1
_________________________1________________________________________________________________________11__________________1
_________________________1________________________________________________________________________11__________________1
_________________________1________________________________________________________________________111_________________1
_________________________1_________11111_____11111____________________________________________________________________1
_________________________1____________________________________________________________________________________________1
_________________________1____________________________________________________________________________________________1
_________________________1____________________________________________________________________________________________1
_________________________1____________________________________________________________________________________________1
_________________________1____________________________________________________________________________________________1
_________________________1____________________________________________________________________________________________1
_________________________1____________________________________________________________________________________________1
_________________________1____________________________________________________________________________________________1
_________________________1__________________________________________________________________________________1111111___1
_________________________1____________________________________________________11_____11_____11____11_________11111____1
_________________________1____________________________________________________11_____11_____11____11_________11111____1
_________________________1___________________________________________________________________________________11111____1
_________________________1___________________________________________________________________________________11111____1
_________________________1___________________________________________________________________________________11111____1
_________________________1____________________________________________________________________________________________1
_________________________1_________11111_____11111____________________________________________________________________1
_________________________1________________________1___________________________________________________________________1
_________________________1____________________________________________________________________________________________1
_________________________1____________________________________________________________________________________________1
_________________________1____________________________________________________________________________________________1
_________________________1____________________________________________________________________________________________1
_________________________1____________________________________________________________________________________________1
_________________________1____________________________________________________________________________________________1
_________________________1____________________________________________________________________________________________1
_________________________1____________________________________________________________________________________________1
_________________________1____________________________________________________________________________________________1
_________________________1___________________11111_____111111111___________________111111111111111111111111111111111111
_________________________1_________________________________________________________1___________________________________
_________________________1_________________________________________________________1___________________________________
_________________________1_________________________________________________________1___________________________________
_________________________1_________________________________________________________1___________________________________
_________________________1_________________________________________________________1___________________________________
_________________________1_________________________________________________________1___________________________________
_________________________1_________________________________________________________1___________________________________
_________________________1_________________________________________________________1___________________________________
_________________________1_________________________________________________________1___________________________________
_________________________1_________________________________________________________1___________________________________
_________________________1_________________________________________________________1___________________________________
_________________________1_________________________________________________________1___________________________________
_________________________1_________________________________________________________1___________________________________
_________________________1_________________________________________________________1___________________________________
_________________________1_________________________________________________________1___________________________________
_________________________1_________________________________________________________1___________________________________
__________________________111111111111111111111111111111111111111111111111111111111____________________________________