________________________________________________________________________________________________
________________________________________________________________________________________________
________________________________________________________________________________________________
________________________________________________________________________________________________
________________________________________________________________________________________________
________________________________________________________________________________________________
________________________________________________________________________________________________
________________________________________________________________________________________________
_________________________1111111111111111111111111111111111111111111111111111111111111111111111_
________________________1______________________________________________________________________1
________________________1______________________________________________________________________1
________________________1______________________________________________________________________1
________________________1______________________________________________________________________1
________________________1_____111111___________________________________________________________1
________________________1_____111111___________________________________________________________1
________________________1_____111111___________________________________________________________1
________________________1_____111111___________________________________________________________1
________________________1______________________________________________________________________1
________________________1______________________________________________________________________1
________________________1______________________________________________________________________1
________________________1______________________________________________________________________1
________________________1______________________________________________________________________1
________________________1______________________________________________________________________1
________________________1____11111111__________________________________________________________1
________________________1______________________________________________________________________1
________________________1______________________________________________________________11111___1
________________________1______________________________________________________________________1
________________________1__________________________111111111111111_____________________________1
________________________1__________________________111111______________________________________1
________________________1__________________________111111______________________________________1
________________________1__________________________111111______________________________________1
________________________1__________________________111111______________________________________1
________________________1______________________________________________________________11111___1
________________________1______________________________________________________________________1
________________________1______________________________________________________________________1
________________________1______________________________________________________________________1
________________________1______________________________________________________________________1
________________________1______________________________________________________________________1
________________________1______________________________________________________________________1
________________________1______________________________________________________________11111___1
________________________1_________111__________________________________________________________1
________________________1_________________________________11___________________________________1
________________________1_________________________________11___________________________________1
________________________1_______________________________111111_________________________________1
_________________________111111_________________________111111_________________________________1
________________________1_______________________________111111_________________________________1
________________________1_________________________________11___________________________________1
________________________1_________________________________11___________________________________1
________________________1______________________________________________________________________1
________________________1______________________________________________________________________1
________________________1______________________________________________________________________1
________________________1______________________________________________________________________1
________________________1____________________________________________11111_____________________1
________________________1______________________________________________________________________1
________________________1______________________________________________________________________1
________________________1_____________________________________________________1_____11___1111111
________________________1_____________________________________________________1_____11___1111111
________________________1_____________________________________________________1_____11___1111111
________________________1_____________________________________________________111111111111111111
________________________1_____________________________________________________111111111111111111
_________________________1111111111111111111111111111111111111111111111111111111111111111111111