_______________________________________________________________1111111111111111111111111111111111111111111111111111111111
_______________________________________________________________1111111111111111111111111111111111111111111111111111111111
_______________________________________________________________1111111111111111111111111111111111111111111111111111111111
_______________________________________________________________1111111111111111111111111111111111111111111111111111111111
_______________________________________________________________1111111111111111111111111111111111111111111111111111111111
_______________________________________________________________1111111111111111111111111111111111111111111111111111111111
_______________________________________________________________1111111111111111111111111111111111111111111111111111111111
_______________________________________________________________1111111111111111111111111111111111111111111111111111111111
_______________________________________________________________1111111111111111111111111111111111111111111111111111111111
_______________________________________________________________1111111111111111111111111111111111111111111111111111111111
_______________________________________________________________1111111111111111111111111111111111111111111111111111111111
_______________________________________________________________1111111111111111111111111111111111111111111111111111111111
_______________________________________________________________1111111111111111111111111111111111111111111111111111111111
_______________________________________________________________1111111111111111111111111111111111111111111111111111111111
_______________________________________________________________1111111111111111111111111111111111111111111111111111111111
_______________________________________________________________1111111111111111111111111111111111111111111111111111111111
_______________________________________________________________1111111111111111111111111111111111111111111111111111111111
_______________________________________________________________1111111111111111111111111111111111111111111111111111111111
_______________________________________________________________1111111111111111111111111111111111111111111111111111111111
_______________________________________________________________1111111111111111111111111111111111111111111111111111111111
_______________________________________________________________1111111111111111111111111111111111111111111111111111111111
_______________________________________________________________1111111111111111111111111111111111111111111111111111111111
_______________________________________________________________1111111111111111111111111111111111111111111111111111111111
_______________________________________________________________1111111111111111111111111111111111111111111111111111111111
_______________________________________________________________1111111111111111111111111111111111111111111111111111111111
_______________________________________________________________1111111111111111111111111111111111111111111111111111111111
_______________________________________________________________1111111111111111111111111111111111111111111111111111111111
_______________________________________________________________1111111111111111111111111111111111111111111111111111111111
________________________________________________________________________________________________________________________1
________________________________________________________________________________________________________________________1
________________________________________________________________________________________________________________________1
________________________________________________________________________________________________________________________1
________________________________________________________________________________________________________________________1
_____________1111111111111111111111111111111111111______________________________________________________________________1
___________1_______________________11____________1______________________________________________________________________1
___________1_______________________11___________________________________________________________________________________1
___________________________________11___________________________________________________________________________________1
___________________________________11___________________________________________________________________________________1
________________________________________________________________________________________________________________________1
11111111111111111111____________________________________________________________________________________________________1
11111111111111111111_____________________11111111_______________________________________________________________________1
11111111111111111111_____________________111111111______________________________________________________________________1
11111111111111111111________111111111_______________________________________________________1111________________________1
11111111111111111111________111111111__________________________________1111111111_________11111111111111111111__________1
1111111111111111111111______111111111________________________________111111111111111______11111111111111111111_11___11__1
111111111111111111111111_____________________111111__________________111111111111111______11111111111111111111__________1
11111111111111111111_________________________________________________111111111111111______11111111111111111111__________1
11111111111111111111_________________________________________________111111111111111______11111111111111111111_11___11__1
11111111111111111111_________________________________________________111111111111111______1111111111111111111___________1
1111111111111111111111111______________________11____________________111111111111111______1111111111111111111___________1
11111111111111111111111______________________11111___________________111111111111111______1111111111111111111___________1
_________11___________1______________________111_____________________111111111111111______11111111111111111111_11___11__1
________________________________111111111____________________________111111111111111____________________________________1
_____________________________________________________________________111111111111111____________________________________1
_____________________________________________________________________111111111111111____________________________________1
_____________________________________________________________________111111111111111____________________________________1
_____________________________________________________________________111111111111111___________________1________________1
_____________________________________________________________________111111111111111_______111111111111________________11
_____________________________________________________________________111111111111111__________________1___11_11_________1
________________________________________________________________________111111111_____________________1___11_11_________1
______________________________________________________________________________________________________11111111111_______1
__________________________________________________111_____________1__________________1____________111_11111111111_______1
111111111111111111111111111111111111111111111111111___________________________________________________11111111111_______1
1________________________11111111111111111111111111____________________________11_____________________11111111111_______1
1________________________11111111111111111111111111________________11______________1__________________11111111111_______1
1________________________11111111111111111111111111________________1111___________111___________11111111111111111_____111
1______________111111111111111111111111111111111111_____________________________________________11111111111111111_______1
1______________111111111111111111111111111111111111_____________________________________________11111111111111111_______1
11_____1_______111111111111111111111111111111111111________________________________________111111111111111111111111111111
1111_111_______111111111111111111111111111111111111________________________________________111111111111111111111111111111
1111___________111111111111111111111111111111111111____________1____1______________1_______111111111111111111111111111111
1______________111111111111111111111111111111111111____________1__11111____________1111____1111111111111111111111____1111
1______________111111111111111111111111111111111111____________1__1_______________11111____1111111111111111111111____1111
1____________1_1111111111111111111111111111111111111___________1___________________________1111111111111111111111____1111
1_111__________1111111111111111111111111111111111111___________________________________1________________________________1
1______________111111111111111111111111111111111111_____________________________________________________________________1
1______________111111111111111111111111111111111111_____________________________________________________________________1
1________11111_111111111111111111111111111111111111_____________________________________________________________________1
1______________111111111111111111111111111111111111_____________________________________________________________________1
11111__________111111111111111111111111111111111111_____________________111111__________________________________________1
11111__________111111111111111111111111111111111111_____________________111111__________________________________________1
1________1___1_111111111111111111111111111111111111_____________________________________________________________________1
1______________111111111111111111111111111111111111_____________________________________________________________________1
1______________111111111111111111111111111111111111_____________________________________________________________________1
1______________111111111111111111111111111111111111__________11_________________________1_______________________________1
11111____1___1_111111111111111111111111111111111111____________________________________________________________1111111111
1______________111111111111111111111111111111111111______________________________________11111111_1____________1111111111
1______________111111111111111111111111111111111111_____________________11111111111111_________________________1111111111
1______________111111111111111111111111111111111111____________111111111111111111111___________________111111111111111111
11__1____1___1_111111111111111111111111111111111111____________111111111111111111111___________________111111111111111111
1______________111111111111111111111111111111111111____________111111111111111111111___________________111111111111111111
1______________1111111111111111111111111___11111111____________111111111111111111111_______________11__111111111111111111
111111__111111111111111111111111111________________1___________111111111111111111111______________11111111111111111111111
1__________________________________________________1___________111111111111111111111___________________111111111111111111
1______________________________________________________________111111111111111111111___________________111111111111111111
1______________________________________________________________111111111111111111111_______________1111111111111111111111
1______________________________________________________________111111111111111111111______________11111111111111111111111
1______________________________________________________________111111111111111111111___________________111111111111111111
1______________________________________________________________111111111111111111111___________________111111111111111111
1______________________________________________________________111111111111111111111_______________1___111111111111111111
1______________________________________________________________111111111111111111111___________________111111111111111111
1______________________________________________________________111111111111111111111___________________111111111111111111
1______________________________________________________________111111111111111111111___________________111111111111111111
1______________________________________________________________111111111111111111111______________111______11111111111111
1______________1__111111111111111111111111111111111___________1111111111111111111111_______________________11111111111111
1______________1__________________________________1___________1111111111111111111111_______________________11111111111111
1______________1______11___11__________________________________111111111111111111111___________________1___1_____11111111
1_______11111111________________________________11_____________111111111111111111111____________________1111_____11111111
1_______11111111________________________________11_____________111111111111111111111__________1__________________11111111
1111111111111111________________11111111_______________________111111111111111111111111______111________________111111111
1111111111111111_____111111111111111111111_____________________111111111111111111111111____1_111________________111111111
1111111111111111_____111111111111111111111_____________________11111111111111111111111111__1_111__1______________11111111
1111111111111111_____11111111111_______________________________11111111111111111111111111_________11111_________________1
11111111111111111111111111111111_______________________________11111111111111111111111111_______________________________1
11111111_____________11111111111_______________________________11111111111111111111111111_______________________________1
11111111_____________11111111111______________1________________11111111111111111111111111_111111________________1111111_1
11111111_____________11111111111_______________________________11111111111111111111111111_1111111111111_1_1111111111111_1
11111111_____________11111111111_______________________________11111111111111111111111111_1111111111111___1111111111111_1
11111111_____________11111111111_______________________________11111111111111111111111111_1111111111111___1111111111111_1
11111111_____________1111111111111111_________1________________11111111111111111111111111_1111111111111___1111111111111_1
11111111__1__________11111111111_______________________________11111111111111111111111111_11111111111111__1111111111111_1
11111111_____________11111111111_______________________________11111111111111111111111111_1111111111111___1111111111111_1
11111111_1_1________111111111111__________________1____________11111111111111111111111111_1111111111111__11111111111111_1
11111111__1__________1111111111111111_____________1____________1111111111___1111111111111_______________________________1
111111111____________11111111111______________________________1_111111111___111111111111________________________________1
1_____1____________________________________________1__________1_________________________________________________________1
1__________________________________________1___________________________________________________1________________________1
1____________________________________1111111____________________________________________________________________________1
1_______________________________________________________________________________________________________________________1
1_______________________________________________________________________________________________________________________1
1_____________________________________________11________________________________________________________________________1
1____________________________________________1111_______________________________________________________________________1
1____________________________________________11111______________________________________________________________________1
1111111111111111111111111111111111111111111111111111111111111111111111111111111111111111111111111111111111111111111111111