______________________________________________________________________________________________________________________
______________________________________________________________________________________________________________________
______________________________________________________________________________________________________________________
______________________________________________________________________________________________________________________
______________________________________________________________________________________________________________________
______________________________________________________________________________________________________________________
______________________________________________________________________________________________________________________
______________________________________________________________________________________________________________________
____________________________________________1111_________11111111111111111111_______1111______________________________
___________________________________________1____1111111_1____________________1111111____1_____________________________
___________________________________________1___________11_______________________________1_____________________________
___________________________________________1___________11_______________________________1_____________________________
___________________________________________1___________11_______________________________1_____________________________
___________________________________________1___________11_______________________________1_____________________________
___________________________________________1___________11_______________________________1_____________________________
___________________________________________1___________11_______________________________1_____________________________
___________________________________________1___________11_______________________________1_____________________________
___________________________________________1111111_____11_______________________________1_____________________________
___________________________________________1___________11_______________________________1_____________________________
___________________________________________1___________11_______________________________1_____________________________
___________________________________________1____________________________________________11111111______________________
___________________________________________1____________________________________________________1_____________________
___________________________________________1____________________________________________________1_____________________
________________11111111__111111111111111__1____________________________________________________1111__________________
_______________1________11______________1__1___________________________111111_______________________1_________________
_______________1________11______________1111___________________________1____1_______________________1_________________
_______________1_______________________________________________________1____1_______________________1_________________
_______________1_________________________________11111111______________1____1_______________________1_________________
_______________1_______________________________________11______________1____1_______________________1_________________
_______________1_______________________________________11______________1____1_______________________1_________________
_______________1_______________________________________11______________111111_______________________1_________________
_______________111_____________________________________11_________________________________________11__________________
_________________1_____________________________________11_________________________________________11__________________
_________________1_____________________________________11_________________________________________11__________________
_________________1_____________________________________11_________________________________________11__________________
_________________1__________________________111111_____11_________________________________________11__________________
_________________1_____________________________________11_________________________________________11__________________
_________________1111111__________________________________________________________________________11__________________
_________________1________________________________________________________________________________11__________________
_________________1_____________________________________________________111111___________111111____11__________________
_________________1_____________________________________________________1____1___________1____1____11__________________
________________11_____________________________________________________1____1____111____1____1____11__________________
_______________1_______________________________________________________1____1____111____1____1____11__________________
_______________1______111111___________________________________________1____1____111____1____1____11__________________
_______________1______1____1___________________________________________1____1____111____1____1____11__________________
_______________1______1____1___________________________________________1____1___________1____1____11__________________
_______________1______1____1___________________________________________111111___________111111______1_________________
_______________1______1____1________________________________________________________________________1_________________
_______________1______1____1________________________________________________________________________1_________________
_______________1______1____1________________________________________________________________________1_________________
_______________1______111111_______111111111111_____________________________________________________1_________________
_______________1____________________________________________________________________________________1_________________
_______________1____________________________________________________________________________________1_________________
_______________1____________________________________________________________________________________1_________________
_______________1____________________________________________________________________________________1_________________
_______________1____________________________________________________________________________________1_________________
_______________1111111111111111111111111111111111111111111111111111111111111111111111111111111111111__________________
